111111111111
10E011100001
10110000P011
10C0C0000101
10C000V00W11
111111111111