11111111111111111
1E001010010001101
110000101001000C1
111000C0000010001
10001C00000101001
10000C00W00110C01
10000001100010C11
100001C00101E1001
1C0C00C1000011001
10000000P0V000001
10101010010CC0001
1001001000100C011
11111111111111111